NO ./assets/matrix.xpm

SO ./assets/matrix.xpm

WE ./assets/matrix.xpm

EA ./assets/matrix.xpm

F 0,244,0
C 0,0,0

1111111111111111111111111111111
1N00000000000000000000000000001
1111111100111111111111111100001 
1100000000110000000000000000001
110111111011000000000111111111111
11000000001100011111111111111
100001111111011111111111111
10011111111101111111111111
100000000000011111111111111
1111011111000000000000000001
1111000000001111111111111111
1111111111111111111111111111
