NO ./assets/yassine.xpm

SO ./assets/valverde.xpm

WE ./assets/valverde.xpm

EA ./assets/valverde.xpm

F 255,0,0
C 225,100,0

111111111
100000001
100000001
100000001
100001001
100000001
100N00001
100000001
100000001
111111111